HHHHHHHHHHHHHHHH
WwwwwwwwwwwwwwwW
W..............W
W..............W
W...W.....W....W
W..............W
W..............W
W......W.......W
L..............d
W......W.......W
W..............W
W..............W
W...W.....W....W
W..............W
W..............W
WWWWWWWWWWWWWWWW