HHHHHHHHHHHHHHHH
WwwwwwwwwwwwwwwW
W..............W
W..............W
W..............W
W..............W
W..............W
W..............W
W.........b....W
W..............W
W..............W
W..............W
W..............W
W..............W
W..............W
WWWWWWWWWWWWWWWW