HHHHHHHHHHHHHHHH
WwwwwwwwwwwwwwwW
W..............W
W..............W
W..............W
W..............W
W..............W
W..............W
W..............DW
W..............W
W..............W
W..............W
W..............W
W..............W
W..............W
WWWWWWWWWWWWWWWW