HHHHHHHHHHHHHHHH
WWWWWWWWWWWWWWWW
W.B............W
W....WWW....B..W
W....W.........W
W.B..WWWWWW....W
W.......S.W.S..W
W..WWWWW..W....W
L..W...WWWW....DW
W..W...........W
WS.W..WWWWW....W
W..WWWW.S.W.B..W
W.........W....W
W.........W....W
W..B.....S.....W
WWWWWWWWWWWWWWWW