HHHHHHHHHHHHHHHH
WWWWWWWWWWWWWWWW
W......B.......W
W.B............W
W...W..W..W..S.W
W......B.......W
W...W.....W....W
WWW..........WWW
L..............DW
WWW..........WWW
W...W.....W..B.W
W......S.......W
W.B.W..W..W....W
W...........S..W
W.....S........W
WWWWWWWWWWWWWWWW