HHHHHHHHHHHHHHHH
WWWWWWWWWWWWWWWW
W......W.......W
W......W..WWW..W
W....B.W..W.W..W
W..WW..W..WWW..W
W......W.......W
W............S.W
L..............DW
W........B.....W
W......W.......W
W..WW..W..WWW..W
W......W..W.W..W
W..S...W..WWWS.W
W......W.......W
WWWWWWWWWWWWWWWW