HHHHHHHHHHHHHHHH
WWWWWWWWWWWWWWWW
W.W............W
W..S.......W...W
W.W.....B......W
W..............W
W.W....WWWW....W
W...........S..W
L.W..W.........DW
W.W....B.W.....W
W.W.........W..W
W.W.S....B.....W
W..............W
W...WW..W...S..W
W..............W
WWWWWWWWWWWWWWWW