HHHHHHHHHHHHHHHH
WWWWWWWWWWWWWWWW
W..W........W..W
W..............W
W....w..WWW....W
W....W.B....S..W
W..............W
W....WWWWWW....W
L....W....W.B..DW
W....WWWWWW....W
W...........WW.W
W....W..S......W
W....WWW.......W
W..W........W..W
W......B.......W
WWWWWWWWWWWWWWWW