HHHHHHHHHHHHHHHH
WWWWWWWWWWWWWWWW
W..............W
W....WW...B....W
WB.............W
W.....WW.......W
W...B.......B..W
W.......WW.....W
L..............DW
W.......WW..S..W
W..............W
W..S..WW.......W
W..............W
W....WW....B...W
W.S............W
WWWWWWWWWWWWWWWW