HHHHHHHHHHHHHHHH
WWWWWWWWWWWWWWWW
W..........W...W
W....S.W.......W
W......W.......W
W...W......WW..W
W...W..........W
W...WW...W.S...W
L......B.W.S...DW
W........W.S...W
W.WWW..........W
W....S...W.....W
W.B...W........W
W.....W.....WW.W
W........S.....W
WWWWWWWWWWWWWWWW